robotics hardware -> open hardware electronic devices -> arduino
pickup truck racing (series) -> auto racing series in canada
celtic musical instruments -> cajun musical instruments -> bowed instruments
forensic databases -> criminal records
electrophysiology -> electrodiagnosis
normal distribution -> multivariate continuous distributions -> continuous distributions
christian songs -> christian music genres -> byzantine hymnographers
national institute of standards and technology -> buildings and structures in gaithersburg, maryland
criminal law -> american legal terminology
united states assistant secretaries of the navy -> american philatelic society -> american people of english descent -> 19th-century american episcopalians
oily fish -> cold water fish
engine technology -> automotive software
heraclitus -> energy and instincts -> concepts in ancient greek logic -> christology -> christian philosophy
chess terminology -> chess openings
judicial remedies -> equity (law)
shaving -> cutting tools
virginia commonwealth university -> george mason university -> college of william & mary
rescue -> morse code -> emergency communication -> distress signals -> brevity codes
international travel documents -> council of the european union
newar -> former monarchies of asia -> former kingdoms -> federal constitutional republics
rhinoceroses -> megafauna of eurasia -> megafauna of africa -> herbivorous animals
grammy award winners -> american male songwriters -> american jazz singers -> academy honorary award recipients -> 20th-century american male actors
radio stations in virginia -> low-power fm radio stations in virginia
el cerrito, california -> concord, california -> antioch, california
patient protection and affordable care act -> healthcare reform legislation in the united states -> controversies in the united states
electronics industry in london -> defunct record labels of the united kingdom -> british record labels
silk road -> animal glandular products
phases of matter -> astrophysics
people of the republic of florence -> ac with 19 elements -> 16th-century italian sculptors -> 15th-century italian painters
nbc network affiliates -> american television stations with a three-letter call sign
vector graphics editors for linux -> free vector graphics editors -> free diagramming software
immunohistochemistry -> anatomical pathology
backup software for windows -> backup software for os x
currencies of zimbabwe -> circulating currencies
self-hosting software -> git (software)
noise music -> nightclubs in new york city -> former music venues in new york city
united states army -> military acquisition
psychology experiments -> behavioral experimentation software
laboratory porcelainware -> alchemical tools
codes of conduct -> branding terminology
excises -> controversies in the united states
fabulists -> ballistics experts -> 16th-century scientists -> 16th-century italian painters -> 15th-century italian painters
narrative techniques -> latin legal terminology -> flagged dictionary definitions
grammy legend award -> american male radio actors -> academy honorary award recipients -> 20th-century american male actors
democratic party presidents of the united states -> bulloch family -> american philatelic society -> 19th-century american episcopalians
singlechart usages for billboardalternativesongs -> musicbrainz release group different from wikidata -> interscope records singles -> billboard alternative songs number-one singles -> beck songs
podcasting software -> free audio editors -> audio editing software for linux
public key infrastructure -> computing infrastructure
china -> brics nations
non-petroleum based lubricants -> dry lubricants
static program analysis -> program analysis
nucleotides -> exercise physiology -> coenzymes -> chemboxes which contain changes to watched fields -> adenosine receptor agonists
verismo operas -> operas -> fictional singers -> adaptations of works by victorien sardou
recipients of the order of the star of italian solidarity -> cecil b. demille award golden globe winners -> american people of sicilian descent -> 20th-century american singers -> 20th-century american male actors
congressional gold medal recipients -> academy honorary award recipients -> 20th-century american male actors
east asia -> disputed territories in asia
women chief technology officers -> iranian chief technology officers -> american chief technologists
economics -> economic theories
american alcoholic drinks -> alcopop
wars involving the republic of china -> wars involving france -> wars involving cuba -> french third republic
military -> defense
scientific simulation software -> hydrology models -> hydrogeology
8th-century deaths -> 7th-century english people -> 7th-century births
google events -> free diagramming software
jackets -> 21st-century fashion -> 19th-century fashion
historical legal occupations -> clay tablets -> ancient egyptian culture
applications using d-bus -> amigaos 4 software
x86 memory management -> windows nt architecture
chinese-american culture in texas -> cantonese language
natural language and computing -> internationalization and localization -> globalization terminology
product certification -> materials testing
wars involving the habsburg monarchy -> wars involving armenia -> history of austria-hungary -> french third republic
optical diodes -> light-emitting diodes -> led lamps
kinematics -> gears
noble metals -> catalysts
wars involving bulgaria -> russo-turkish wars -> global conflicts -> french third republic
currencies of british overseas territories -> currencies of asia -> currencies of africa -> circulating currencies
state departments of labor of the united states -> state agencies of illinois -> labor relations in illinois
dissolution of iraq -> apocalyptic groups -> anti-government factions of the syrian civil war
apocalyptic groups -> anti-government factions of the syrian civil war
hungarian words and phrases -> 18th-century weapons
yoga techniques -> asanas
dec hardware -> 12-bit computers
fruits originating in asia -> apples
property crimes -> crimes
free data analysis software -> free artificial intelligence applications
dietary minerals -> chalcogens -> biology and pharmacology of chemical elements -> antioxidants
organisations based in iraq -> groups practising sexual slavery -> anti-government factions of the syrian civil war
mathematics of infinitesimals -> calculus
united states federal executive departments -> nuclear weapons infrastructure of the united states -> military-industrial complex
sleep physiology -> sleep
american people of italian descent -> american male voice actors -> american film producers -> academy honorary award recipients -> 20th-century american male actors
weapons of russia -> infantry weapons of the cold war -> cold war weapons of the soviet union -> 7.62 mm machine guns
streaming media systems -> copyright law
soil-based building materials -> requests for audio pronunciation (spanish) -> buildings and structures by construction material -> adobe buildings and structures
university towns in the united states -> incorporated cities and towns in california -> academic enclaves
sri international software -> software using the lppl license -> free tex software
organizations designated as terrorist by russia -> iraq war -> dissolution of syria -> anti-government factions of the syrian civil war
giftedness -> 16th-century italian painters -> 15th-century italian painters
best supporting actor academy award winners -> american crooners -> 20th-century american male actors
video game sequels -> vaporware -> source (game engine) games -> free-to-play video games -> first-person shooter multiplayer online games -> fictional mercenaries
vaporware -> fictional mercenaries
persecution of christians -> apocalyptic groups -> anti-government factions of the syrian civil war
emergency management in the united states -> continuity of government in the united states
nursing research -> drug discovery
computational complexity theory -> analysis of algorithms
cecil b. demille award golden globe winners -> 20th-century american male actors
telephone crimes -> fraud in india -> confidence tricks
mythological human hybrids -> monsters -> ancient greek culture -> ancient greek art -> ancient egyptian symbols
psychiatric assessment -> neurophysiology -> brainâ€“computer interfacing
plot (narrative) -> fantasy tropes
crown dependencies -> bailiwick of jersey
plant common names -> negligibly senescent organisms
branches of biology -> biomedicine
unix text editors -> free file comparison tools
university of michigan -> solar car racing
american film producers -> 20th-century american male actors
national symbols of finland -> granite -> felsic rocks
american anti-fascists -> 20th-century american episcopalians -> 19th-century american episcopalians
source (journalism) -> public relations techniques
pervasive developmental disorders -> learning disabilities
toads -> tetrapod common names
teenage mutant ninja turtles -> corporate mascots -> comics adapted into video games -> comics adapted into animated series -> child superheroes -> anthropomorphic martial artists -> animal superheroes -> american comics adapted into films
industrial processes -> glass coating and surface modification -> forming processes
insect products -> animal glandular products
staining -> immunohistochemistry -> anatomical pathology
rna splicing -> rna
grit affiliates -> bounce tv affiliates -> american television stations with a three-letter call sign
wars involving panama -> wars involving canada -> wars involving bulgaria -> french third republic
personal financial problems -> law by issue
fruit vegetables -> cucurbitaceae
vocal music -> opera history -> opera -> drama
relationship counseling -> psychotherapy
united states department of energy agencies -> electric grid interconnections in north america
dutch-speaking countries and territories -> 10th-century establishments in aruba
mathematical artists -> leonardo da vinci -> fabulists -> 15th-century italian painters
reading (process) -> learning to read -> education in the united states
wars involving belgium -> modern history of italy -> global conflicts -> french third republic
rhetoric -> energy and instincts -> christian philosophy
malnutrition organizations -> international medical and health organizations -> agriculture in society
signal transduction -> integral membrane proteins -> g protein coupled receptors
islamism in syria -> anti-shi'ism -> anti-government factions of the syrian civil war
craft occupations -> carpentry
biomaterials -> animal glandular products
member states of the south asian association for regional cooperation -> former monarchies of asia -> federal constitutional republics
seventh-generation video game consoles -> regionless game consoles -> playstation portable -> handheld game consoles
united states contract case law -> companies that have filed for chapter 7 bankruptcy
academy honorary award recipients -> 20th-century american male actors
incorporated cities and towns in california -> academic enclaves
hoteliers -> hospitality management
space technology research institutes -> jet propulsion laboratory -> 20th century in los angeles
communism -> anarchist theory
home video supplements -> comics terminology
gecko-based software -> free web browsers -> firefox
2nd-century romans -> 1st-century romans -> 1st-century greek people
cantonal capitals of switzerland -> border tripoints -> basel
rivers of massachusetts -> geobox usage tracking for river type -> charles river
route planning software -> google maps
simple directmedia layer -> linux apis
premixed alcoholic drinks -> alcopop
science fiction fanzines -> fictional technology -> faster-than-light communication
food safety organizations -> american medical research
official documents -> council of the european union
project hosting websites -> computing websites
iraq war -> anti-government factions of the syrian civil war
iucn red list vulnerable species -> gallirallus -> flightless birds -> birds of new zealand
light-emitting diodes -> led lamps
ethnology -> ethnography -> anthropology
art genres -> american art
latin words and phrases -> greek goddesses
university towns in switzerland -> cities in switzerland -> cantonal capitals of switzerland -> basel
internet relay chat -> denial-of-service attacks
currencies of the kingdom of the netherlands -> currencies of ecuador -> circulating currencies
mpeg-2 -> interactive television
game engines that support vulkan -> epic games
wars involving germany -> wars involving cuba -> french third republic
proteomics -> genomics
greek gods -> 8th-century bc poets
italian renaissance sculptors -> giftedness -> 15th-century italian painters
macos development -> mac os development
8th-century christian saints -> 7th-century births
fiction -> fantasy tropes
video games set in russia -> electronic arts games -> crave entertainment games
fictional turtles -> american comics adapted into films
team sports -> sports terminology
society for worldwide interbank financial telecommunication -> la hulpe -> financial markets software
american politicians with physical disabilities -> 20th-century american episcopalians -> 19th-century american episcopalians
openbsd software using the isc license -> openbsd
dutch hip hop groups -> american hip hop groups
year of birth missing -> 11th-century iranian people -> 10th-century monarchs in asia -> 10th-century iranian people
nepali-speaking countries and territories -> member states of the south asian association for regional cooperation -> federal constitutional republics
information operations and warfare -> electronic warfare
disk images -> compact disc and dvd copy protection
randomized algorithms -> monte carlo methods
contemporary art -> american art
organisations designated as terrorist by the european union -> organisations based in iraq -> anti-government factions of the syrian civil war
playstation network games -> playstation 4 games
free learning support software -> free learning management systems
wars involving ireland -> wars involving honduras -> wars involving guatemala -> wars involving australia -> global conflicts -> french third republic
hydrology models -> hydrogeology
teens in fiction -> image comics teams -> anthropomorphic martial artists -> american comics adapted into films
populated places on the rhine -> cultural property of national significance in basel-stadt -> basel
age of enlightenment -> 15th-century italian painters
currencies of the united states -> currencies of the kingdom of the netherlands -> circulating currencies
science education -> protected areas -> environmental education -> earth sciences
raytheon products -> cold war surface-to-air missiles of the united states
19th-century weapons -> 18th-century weapons
buildings and structures in davao city -> airports in the philippines
telephony signals -> digital audio recording
physical universe -> physical cosmology
restaurant terminology -> culinary terminology -> chefs
sinology -> isolating languages -> analytic languages
meego -> indian premier league franchise owners
playstation (brand) -> handheld game consoles
state agencies of illinois -> labor relations in illinois
people from montauban -> 19th-century painters of historical subjects -> 18th-century french painters
renaissance scientists -> people from the province of florence -> 16th-century scientists -> 15th-century italian painters
environmental policy in the united states -> environmental policies organizations -> environmental agencies in the united states
members of the acadÃ©mie des beaux-arts -> 18th-century french painters
tibia -> bones of the lower limb
music venues -> buildings and structures by type
financial news agencies -> electronic trading platforms
health charities in australia -> charities based in australia -> air ambulance services in australia
multi-touch mobile phones -> digital audio players
cajun musical instruments -> bowed instruments
spanish words and phrases -> latin music genres -> dance music
papillomavirus -> infectious causes of cancer -> carcinogenesis
morality -> ethical codes -> branding terminology
formal wear -> 21st-century fashion -> 19th-century fashion
wireless sensor network -> mesh networking -> home automation
jet propulsion laboratory -> 20th century in los angeles
eleanor roosevelt -> american people in the venona papers -> american odd fellows -> 20th-century american politicians -> 20th-century american episcopalians -> 19th-century american episcopalians
xbox one -> xbox 360 hardware -> microphones -> infrared imaging -> devices capable of speech recognition -> applied machine learning
python-scriptable game engines -> free game engines
random number generation -> dice
renting -> interest
heuristics -> forensics -> applied sciences
violence against lgbt people -> persecution of muslims -> apocalyptic groups -> anti-government factions of the syrian civil war
river morphology -> physical geography
data types -> composite data types
printing terminology -> print production
money laundering -> commercial crimes
scottish musical instruments -> czech musical instruments -> bowed instruments
radio stations in chicago -> defunct radio stations in the united states -> blues radio stations
companies that have filed for bankruptcy in canada -> accounting scandals
no wave -> nightclubs in new york city -> former music venues in new york city
global conflicts -> french third republic
symbols of georgia (u.s. state) -> dielectrics
rolling stock manufacturers of germany -> manufacturers of industrial automation
email authentication -> computer security standards
peripheral component interconnect -> motherboard expansion slot
recipients of the austrian cross of honour for science and art, 1st class -> american pop singers -> american philanthropists -> 20th-century american singers -> 20th-century american male actors
tax evasion -> money laundering -> commercial crimes
personality -> new thought beliefs
clinical procedure classification -> american medical association
cycling in california -> academic enclaves
terrorism in turkey -> organisations designated as terrorist by the united kingdom -> islamism in iraq -> dissolution of iraq -> anti-government factions of the syrian civil war
las vegas entertainers -> burials at desert memorial park -> best musical or comedy actor golden globe (film) winners -> american film producers -> 20th-century american male actors
os/2 web browsers -> gecko-based software -> firefox
slovak-language surnames -> slavic-language surnames -> czech-language surnames
piezoelectric materials -> dielectrics
international sports bodies based in switzerland -> international olympic committee
fa cup winners -> defunct football clubs in england
sustainable building rating systems -> sustainable building in the united states -> environmental design -> energy in the united states -> building energy rating
emi -> defunct record labels of the united kingdom -> british record labels
american people of hungarian-jewish descent -> american freemasons -> american aviators
energy models -> climate change mitigation
education in chittenden county, vermont -> buildings and structures in burlington, vermont
astronomical events -> astrological aspects
vyatka governorate -> rural localities in the udmurt republic
lifting equipment -> forklift truck manufacturers
news agencies based in the united states -> electronic trading platforms
transport systems -> internet -> cultural globalization
members of the guild of saint luke -> 15th-century scientists -> 15th-century italian painters
transliteration -> information and communication technologies for development -> globalization terminology
openvms text editors -> free file comparison tools
faroese musical instruments -> czech musical instruments -> bowed instruments
sociology of scientific knowledge -> social constructionism -> history of technology
woodworking hand-held power tools -> metalworking hand tools
private middle schools in mississippi -> private high schools in mississippi -> private elementary schools in mississippi
ballistics experts -> 15th-century italian painters
transmission (record label) live albums -> porcupine tree live albums
converts to roman catholicism from atheism or agnosticism -> american male radio actors -> 20th-century american male actors
american skeptics -> american magicians -> american aviators
national symbols of spain -> national symbols of poland -> national symbols of germany -> national symbols of armenia -> accipitridae
spectrometers -> mass spectrometry
christian female saints of the middle ages -> 7th-century births
renaissance architects -> florentine painters -> ballistics experts -> 15th-century italian painters
ethnography -> anthropology
internet privacy software -> history of cryptography
pack animals -> domesticated animals
kingdom of the netherlands -> aruba -> 10th-century establishments in aruba
grammar frameworks -> generative linguistics
visual arts -> arts -> aesthetics
master's degrees -> business qualifications
national symbols of armenia -> accipitridae
water transport -> coastal construction
infectious causes of cancer -> carcinogenesis
oxide minerals -> corundum gemstones -> aluminium minerals
technical analysis -> commodity markets
opinion journalism -> newspaper content
federalism -> constitutional state types
nasa visitor centers -> nasa facilities -> la caÃ±ada flintridge, california -> buildings and structures in los angeles county, california -> 21st century in los angeles -> 20th century in los angeles
rivers of middlesex county, massachusetts -> geobox usage tracking for river type -> charles river
lists of occupations -> corporation-related lists
american philatelic society -> 19th-century american episcopalians
woodworking machines -> woodworking hand-held power tools -> metalworking hand tools
windows nt kernel -> linux drivers
egyptian legendary creatures -> ancient greek culture -> ancient egyptian symbols
american male radio actors -> 20th-century american male actors
sensory organs -> eye
royal flying doctor service of australia -> organisations based in australia with royal patronage -> air ambulance services in australia
feature detection (computer vision) -> change detection
chinese language -> analytic languages
consumer financial protection bureau -> chris dodd
types of editors -> copy editing
russo-turkish wars -> french third republic
sphyraenidae -> fish of bangladesh
american male voice actors -> 20th-century american male actors
totalitarian states -> organisations designated as terrorist by australia -> iraq war -> anti-government factions of the syrian civil war
sounds by type -> sound
united states proposed federal legislation -> proposed legislation of the 114th united states congress -> copyright enforcement
electrical test equipment -> electrical meters
christian music genres -> byzantine hymnographers
union of good -> international sanctions
free audio editors -> audio editing software for linux
birds by common name -> accipitridae
roseland, new jersey -> automatic data processing
professional associations based in the united states -> business and finance professional associations
currencies of ecuador -> circulating currencies
nascar on television -> automotive television series
comics adapted into animated films -> animal superheroes -> american comics adapted into films
american crooners -> 20th-century american male actors
international cultural organizations -> arts in turkey
ancient smyrnaeans -> ancient chians -> 8th-century bc poets
pathology -> histology -> anatomical pathology
wind turbine manufacturers -> home appliance manufacturers -> electrical wiring and construction supplies manufacturers
christian music -> byzantine hymnographers
social constructionism -> history of technology
guatemalan musical instruments -> central american and caribbean percussion instruments -> c instruments
xbox 360 games -> video games with commentaries -> playstation 3 games -> free-to-play video games -> fictional mercenaries
destroyed landmarks in russia -> buildings and structures in moscow
provincial symbols of british columbia -> chinese culture
science and technology in canada -> blackberry limited mobile phones
cellular respiration -> adenosine receptor agonists
organized crime activity -> money laundering -> commercial crimes
american magicians -> american aviators
federal communications commission -> emergency telephone numbers
united states army equipment -> equipment of the united states air force
sony consoles -> playstation portable -> handheld game consoles
municipalities of basel-stadt -> basel
statistical tests -> analysis of variance
posix web browsers -> firefox
united states corporate law -> sarbanesâ€“oxley act
insulin therapies -> diabetes
web mapping -> keyhole markup language
sunni islamist groups -> irregular military -> groups practising sexual slavery -> anti-government factions of the syrian civil war
materials -> environmental law
indoor ice hockey venues in canada -> guelph storm -> buildings and structures in guelph
italian inventors -> ballistics experts -> 15th-century italian painters
etiquette -> cultural anthropology
lusophone music -> brazilian styles of music
military vehicle manufacturers -> aircraft engine manufacturers of japan
zhongguancun -> lenovo
livestock guardians -> livestock -> domesticated animals
german-speaking countries and territories -> german language
mythological felines -> egyptian legendary creatures -> ancient egyptian symbols
transportation in crisp county, georgia -> airfields of the united states army air forces in georgia (u.s. state)
divination -> ancient greek religion
mathematics in medicine -> electrophysiology -> electrodiagnosis
v-12 navy college training program -> technological universities in the united states -> technical universities and colleges -> massachusetts institute of technology -> engineering universities and colleges in massachusetts
laws affecting youth rights -> 75th united states congress
lan airlines -> airlines of brazil
tennis leagues in the united states -> exhibition tennis tournaments
web browsers for linux -> free web browsers -> firefox
video on demand -> online services
escapologists -> american freemasons -> american aviators
fictional technology -> faster-than-light communication
dos/4gw games -> dos extenders
national symbols of egypt -> accipitridae
plants and pollinators -> hydroponic plants -> fruit vegetables -> cucurbitaceae
prix de rome for painting -> members of the acadÃ©mie des beaux-arts -> 18th-century french painters
mirage studios titles -> corporate mascots -> american comics adapted into films
dna profiling techniques -> amplifiers
statistical data coding -> mental and behavioural disorders -> diagnosis classification
nightclubs in new york city -> former music venues in new york city
software that uses xul -> firefox
dec microprocessors -> dec mainframe computers
terrorism in syria -> islamism in iraq -> anti-government factions of the syrian civil war
termcap -> information technology in the netherlands -> beos text editors
navigational equipment -> air traffic control
microsoft divisions -> macos instant messaging clients -> companies in the prism network
consultants -> advisors
supply chain analytics -> forecasting
grammy lifetime achievement award winners -> frank sinatra -> columbia records artists -> american film directors -> academy honorary award recipients -> 20th-century american male actors
criminology -> applied sciences
string similarity measures -> measure theory
cognitive psychology -> behaviorism
drugs with non-standard legal status -> drugboxes which contain changes to watched fields -> anticonvulsants
oral communication -> language education
copyright infringement of software -> companies that have filed for chapter 7 bankruptcy
wsj topic id same as wikidata -> internal revenue code -> healthcare reform legislation in the united states -> controversies in the united states
mathematical psychology -> computational statistics -> artificial neural networks
majorityâ€“minority relations -> immigration
national symbols of saint lucia -> bamboo taxa -> bamboo
auto racing series in the united states -> auto racing series in canada
transhumanism -> bioethics
groups practising sexual slavery -> anti-government factions of the syrian civil war
national medal of technology recipients -> collier trophy recipients
8th-century english people -> 8th-century christian saints -> 7th-century births
italian military engineers -> fabulists -> 15th-century italian painters
deaths from peritonitis -> american aviators
2nd-century historians -> 1st-century romans -> 1st-century greek people
financial regulatory authorities of the united states -> bank regulation in the united states
medical aspects of death -> criminology -> applied sciences
rock mechanics -> petrology -> mining engineering
disk image emulators -> compact disc and dvd copy protection
names of god in christianity -> christian philosophy
sealed computers -> macintosh all-in-ones -> imac series
statements -> concepts in epistemology
divided regions -> disputed territories in asia
mathematical logic -> algorithms
manmohan singh administration -> counter-terrorism in india
superfund sites in california -> buildings and structures in los angeles county, california -> 20th century in los angeles
unmanned spacecraft -> meteorological data and networks
renaissance painters -> age of enlightenment -> 15th-century italian painters
emergency services -> carnegie mellon university
interior design -> decorative arts
coenzymes -> adenosine receptor agonists
soccer leagues in canada -> professional soccer leagues in the united states -> major league soccer
sports trophies and awards -> most valuable player awards
radiometry -> optical metrology
distress signals -> brevity codes
united states department of homeland security agencies -> emergency organisations -> continuity of government in the united states
value (ethics) -> cultural economics
provincial and territorial orders of canada -> members of the national order of quebec
mobile route-planning software -> google maps
health insurance marketplaces -> cgi group
mesh networking -> home automation
organizations awarded nobel peace prizes -> intergovernmental panel on climate change -> climate change organizations
costa rican musical instruments -> central american and caribbean percussion instruments -> c instruments
wood finishing materials -> printing materials -> painting materials
16th-century scientists -> 15th-century italian painters
postscript -> concatenative programming languages
megafauna of eurasia -> herbivorous animals
synchronous programming languages -> pedagogic integrated development environments
religious music -> christian terminology -> christian songs -> byzantine hymnographers
liberalism -> community organizing -> communism -> anarchist theory
personal defense weapons -> firearms by type
web map services -> mobile route-planning software -> google maps
burials at pÃ¨re lachaise cemetery -> academic art -> 18th-century french painters
romance countries and territories -> member states of the council of europe -> iberian peninsula
survival skills -> rescue -> brevity codes
medical privacy legislation -> insurance legislation
united states federal appropriations legislation -> presidency of ronald reagan
office suites for linux -> linux word processors
welsh musical instruments -> violins -> czech musical instruments -> bowed instruments
protein families -> membrane biology -> g protein coupled receptors
social finance -> ethical codes -> branding terminology
geobox usage tracking for river type -> charles river
embedded microprocessors -> digital signal processors
sabres -> police weapons -> early modern european swords -> 18th-century weapons
internet law in the united states -> copyright enforcement
philosophical theories -> personality -> new thought beliefs
roman-era greek historians -> hellenistic egyptians -> 2nd-century historians -> 1st-century greek people
vietnam -> socialist states -> member states of the association of southeast asian nations
american episcopalians -> 19th-century american episcopalians
singlechart usages for billboardhot100 -> beck songs
former nationalised industries of the united kingdom -> bp
p-complete problems -> convex optimization
rebel groups in egypt -> organisations based in iraq -> anti-government factions of the syrian civil war
free terminal emulators -> free communication software
greek culture heroes -> ancient chians -> 8th-century bc poets
hardstone carving -> chinese culture
vernacular architecture -> soil-based building materials -> adobe buildings and structures
rivers of worcester county, massachusetts -> rivers of massachusetts -> charles river
microblogging -> macos software
video games set in uganda -> video games set in mexico -> electronic arts games -> crave entertainment games
latam airlines group -> lan airlines -> airlines of brazil
waste legislation in the european union -> mercury (element) -> european union directives -> environmental chemistry -> electronic waste in europe
wars involving south africa -> wars involving azerbaijan -> global conflicts -> french third republic
monolithic kernels -> linux kernel
oral epic poets -> homer -> greek speculative fiction writers -> greek culture heroes -> 8th-century bc poets
power tools -> metalworking hand tools
computational statistics -> artificial neural networks
wars involving the united states -> wars involving the united kingdom -> wars involving azerbaijan -> french third republic
columbia law school alumni -> 20th-century american politicians -> 19th-century american episcopalians
targeting (warfare) -> radar -> air traffic control
wireless energy transfer -> microwave transmission -> energy development
lists of coordinates -> geographic coordinate lists
energy in transport -> aerodynamics
raster graphics editors for linux -> free photo software
free industrial software -> free accounting software
misuse of statistics -> ethics and statistics
clouds -> climate forcing agents
presidents of the united states who died while in office -> democratic party presidents of the united states -> 19th-century american episcopalians
water treatment -> water pollution -> waste treatment technology
leave -> family law in the united states -> clinton administration initiatives
muricidae -> gastropod genera
gallirallus -> birds of new zealand
symbian os -> accenture
landforms of boston -> charles river
shades of black -> dry lubricants
sociological theories -> complex systems theory -> communication theory
formula one engine manufacturers -> british racecar constructors -> british auto racing teams
tor (anonymity network) -> free software programmed in pascal -> free instant messaging clients
wars involving guatemala -> french third republic
italian renaissance humanists -> italian physiologists -> italian military engineers -> 15th-century italian painters
tourist attractions in burlington, vermont -> flagship universities in the united states -> education in chittenden county, vermont -> buildings and structures in burlington, vermont
prediction -> logistic regression
anthropomorphic martial artists -> american comics adapted into films
free software programmed in pascal -> free instant messaging clients
speech processing -> speaker recognition
forensics -> applied sciences
wars involving armenia -> french third republic
virtual communities -> internet services supporting openid
blind writers -> 8th-century bc poets
small island developing states -> dutch-speaking countries and territories -> 10th-century establishments in aruba
modern history of italy -> french third republic
ship types -> sailing rigs and rigging -> clippers
guelph storm -> buildings and structures in guelph
italian physiologists -> 15th-century italian painters
transformers (electrical) -> electric power conversion
people from appleton, wisconsin -> hungarian jews -> american stunt performers -> american performance artists -> american freemasons -> american aviators
american stunt performers -> american aviators
ships transferred under project hula -> admirable-class minesweepers of the soviet navy -> admirable-class minesweepers
transistorized computers -> dec hardware -> 12-bit computers
power cables -> building code
pakistani films -> films set in sydney -> films set in lahore
linux archivers and compression-related utilities -> git (software)
wars involving canada -> french third republic
foundations based in germany -> education in dresden
economics models -> climate change policy -> climate change mitigation
special education -> psychiatric diagnosis -> neurological disorders in children -> learning disabilities
nuclear weapons infrastructure of the united states -> military-industrial complex
16th-century italian people -> 15th-century scientists -> 15th-century italian painters
navigation -> geodesy
visualization api -> javascript visualization toolkits
currencies of east timor -> currencies of africa -> circulating currencies
nuclear medicine -> medical physics
capitol records artists -> american crooners -> 20th-century american male actors
japanese tea -> green tea
video formats -> display technology
transmembrane receptors -> human proteins
burials at desert memorial park -> 20th-century american male actors
water pollution -> waste treatment technology
regression and curve fitting software -> computer algebra system software for os x
republican parties -> international democrat union member parties -> conservative parties in the united states -> conservative parties
distributed data storage systems -> data centers
garden features -> architectural elements
alumni of the Ã©cole des beaux-arts -> 18th-century french painters
works with imslp links -> adaptations of works by victorien sardou
wars involving british india -> wars involving azerbaijan -> french third republic
sonnets -> sonnet studies -> rhyme
video games with 2.5d graphics -> video game graphics
unit operations -> heat transfer
symantec -> certificate authorities
neurophysiology -> brainâ€“computer interfacing
artillery ammunition -> anti-tank rounds
lafayette, california -> danville, california -> concord, california -> antioch, california
wolfram research -> theorem proving software systems -> astronomical databases
progressivism -> community organizing -> anarchist theory
diasporas -> diaspora studies
prophecy -> ancient greek religion
internal revenue code -> controversies in the united states
software synthesizers -> audio programming languages
video games set in antarctica -> video games set in africa -> electronic arts games -> crave entertainment games
united states department of health and human services agencies -> american medical research
ac with 15 elements -> 20th-century american episcopalians -> 19th-century american episcopalians
radioactive contamination -> chemical, biological, radiological and nuclear defense
people whose existence is disputed -> oral epic poets -> 8th-century bc poets
granitic rocks -> granite -> felsic rocks
port cities and towns in switzerland -> franceâ€“germany border crossings -> basel
united states federal boards, commissions, and committees -> bank regulation in the united states
telematics -> automotive electronics
chief technology officers -> american chief technologists
natural language processing toolkits -> natural language parsing
nursing -> military supporting service occupations
single-board computers -> internet of things -> arduino
technical intelligence -> engineering concepts
universities and colleges in cambridge, massachusetts -> rugby league stadiums in the united states -> engineering universities and colleges in massachusetts
mantodea -> insects acting as insect pest control agents -> agriculturally beneficial insects
american roman catholics -> american male singers -> american crooners -> 20th-century american male actors
varnishes -> printing materials -> painting materials
university of vermont -> buildings and structures in burlington, vermont
miquelon-langlade -> airports in saint pierre and miquelon
musicbrainz release group different from wikidata -> beck songs
communes of the province of ancona -> catholic titular sees in europe
mobile linux -> embedded linux distributions
video game ide -> epic games
bulloch family -> 19th-century american episcopalians
historical currencies of the united states -> currencies of oceania -> currencies of asia -> circulating currencies
mercian saints -> 7th-century women -> 7th-century english people -> 7th-century births
school accreditors -> creationist organisations -> associations of schools
devices capable of speech recognition -> applied machine learning
unreal (video game series) -> iphone video game engines -> game engines that support vulkan -> epic games
sustainability -> environmental social science concepts -> economics of sustainability
child superheroes -> american comics adapted into films
smoked fish -> salmonidae -> oily fish -> cold water fish
flushing, queens -> flushing meadowsâ€“corona park -> buildings and structures in queens, new york
french male painters -> academic art -> 18th-century french painters
synthetic aperture radar -> measurement and signature intelligence
tourist attractions in guelph -> buildings and structures in guelph
wars involving azerbaijan -> french third republic
salvadoran musical instruments -> central american and caribbean percussion instruments -> c instruments
world war ii airfields in morocco -> buildings and structures in oriental (morocco) -> airports in morocco -> airfields of the united states army air forces in morocco
pontifical catholic university of rio de janeiro -> lua (programming language)
ninja parody -> nickelodeon -> comics adapted into animated series -> american comics adapted into films
physiognomists -> florentine painters -> 15th-century italian painters
camping world truck series -> auto racing series in the united states -> auto racing series in canada
standardized tests -> educational assessment and evaluation
ancient greeks -> ancient greek poets -> 8th-century bc poets
printing software -> kodak
inverse problems -> estimation methods
paranormal investigators -> american stunt performers -> american aviators
english given names -> arabic feminine given names
franceâ€“germany border crossings -> basel
united kingdom -> england
yahoo! acquisitions -> discontinued yahoo! services
medical hygiene -> antiseptics
hair removal -> cutting tools
entertainment software association -> electronic arts -> academy of interactive arts & sciences members
flushing meadowsâ€“corona park -> buildings and structures in queens, new york
video games set in argentina -> lithtech engine games -> crave entertainment games
language varieties and styles -> jargon -> english language
pattern matching -> automata (computation)
keyboard percussion -> guatemalan musical instruments -> c instruments
socialist states -> member states of the association of southeast asian nations
spiritualism -> professional magicians -> harry houdini -> american freemasons -> american aviators
electronic paper technology -> e-books
opera -> drama
proteins -> genomics
former kingdoms -> federal constitutional republics
hunger relief organizations -> agriculture in society
literary techniques -> fiction -> fantasy tropes
object recognition and categorization -> learning in computer vision
linear programming -> convex optimization
united states supreme court cases of the roberts court -> excises -> controversies in the united states
border tripoints -> basel
hymns -> christian songs -> byzantine hymnographers
hexagonal minerals -> graphite -> dry lubricants
learning to read -> education in the united states
caribbean countries of the kingdom of the netherlands -> 10th-century establishments in aruba
internet -> cultural globalization
mental and behavioural disorders -> diagnosis classification
currencies of asia -> circulating currencies
undead -> supernatural legends -> ghosts
oculus rift games -> fictional mercenaries
telegraphy -> cultural globalization
sca runtime -> sca infrastructure
reprise records artists -> american film producers -> 20th-century american male actors
federations -> federalism -> constitutional state types
notary -> authentication -> applications of cryptography
richmond, california -> antioch, california
cold war weapons of the soviet union -> 7.62 mm machine guns
geoparks -> environmental education -> earth sciences
germanic countries and territories -> england
european union directives -> electronic waste in europe
old dominion university -> college of william & mary
chemboxes which contain changes to watched fields -> adenosine receptor agonists
italian anatomists -> ambassadors of the republic of florence -> 16th-century italian sculptors -> 15th-century italian painters
11th-century iranian people -> 10th-century iranian people
computer algebra system software for windows -> computer algebra system software for os x
northeast asia -> korean-speaking countries and territories -> disputed territories in asia
law enforcement in the united states -> espionage in the united states
islamism in iraq -> anti-government factions of the syrian civil war
speed (tv channel) shows -> nascar on television -> automotive television series
typing -> text
automotive technologies -> automotive lamps
people with poliomyelitis -> governors of new york -> american episcopalians -> 19th-century american episcopalians
christian fasting -> advent
united nations development group -> executive directors of the world food programme -> agriculture in society
lifesaving -> first aid
food preparation appliances -> bartending equipment
hydraulic engineering -> environmental engineering
suicide in fiction -> operas by giacomo puccini -> fictional singers -> adaptations of works by victorien sardou
noble titles -> monarchs
population -> majorityâ€“minority relations -> immigration
ocaml software -> ocaml programming language family
packet analyzer software that uses gtk+ -> macos network-related software
unreal engine -> iphone video game engines -> epic games
international space station -> artificial satellites orbiting earth
member states of nato -> iberian peninsula
ncr corporation -> teradata
united states federal welfare and public assistance legislation -> social security (united states)
video games set in peru -> crave entertainment games
macos graphics-related software -> google events -> free diagramming software
american jazz singers -> 20th-century american male actors
opera history -> drama
pederastic heroes and deities -> lgbt themes in mythology -> fictional greek people
united states law -> united states department of commerce -> military technology
slavic-language surnames -> czech-language surnames
islamic states -> anti-government factions of the syrian civil war
norske skog -> catalyst paper
computing input devices -> applied machine learning
christian radio stations in the united states -> cantonese language
microwave transmission -> energy development
free raster graphics editors -> free photo software
people from the province of florence -> 15th-century italian painters
fidelity national financial -> ceridian
1st-century romans -> 1st-century greek people
islands of the channel islands -> crown dependencies -> bailiwick of jersey
navajo culture -> indigenous architecture
transnational association of christian colleges and schools -> creationist organisations -> associations of schools
extant late cretaceous first appearances -> edible cephalopods -> commercial molluscs -> cenozoic cephalopods
corundum gemstones -> aluminium minerals
university of cambridge computer laboratory -> linux foundation
u.s. synthetic rubber program -> groton school alumni -> dutchess county, new york politicians -> american philatelic society -> 19th-century american episcopalians
national symbols of yemen -> national symbols of liechtenstein -> national symbols of egypt -> accipitridae
isolating languages -> analytic languages
pdp-11 -> massachusetts general hospital
united states federal law -> scientific documents
germanyâ€“switzerland border crossings -> franceâ€“switzerland border crossings -> cultural property of national significance in basel-stadt -> basel
english phrases -> clichÃ©s
environmental design -> building energy rating
software using the zlib license -> linux apis
statistical approximations -> risk analysis methodologies -> monte carlo methods
record producers -> music production
ancient roman festivals -> ancient greek athletic festivals
korean-speaking countries and territories -> disputed territories in asia
irish-language masculine given names -> gaelic-language given names
professional networks -> linkedin
geography education -> earth sciences
american pop singers -> 20th-century american male actors
ancient greek poets -> 8th-century bc poets
wahhabism -> totalitarian states -> anti-government factions of the syrian civil war
politicians with paraplegia -> people associated with the new deal -> columbia law school alumni -> 19th-century american episcopalians
spanish feminine given names -> english given names -> arabic feminine given names
xmpp -> instant messaging protocols
purinergic signalling -> nucleotides -> adenosine receptor agonists
freemen of the city of london -> 20th-century american episcopalians -> 19th-century american episcopalians
regionless game consoles -> handheld game consoles
stage crew -> sound production
environmental education -> earth sciences
mutual funds of the united states -> collective investment schemes
stoicism -> christian philosophy
hall of fame for great americans inductees -> governors of new york -> 19th-century american episcopalians
multiplayer online games -> first-person shooter multiplayer online games -> fictional mercenaries
knights grand cross of the military william order -> 20th-century american episcopalians -> 19th-century american episcopalians
virtual globes -> geographic coordinate lists
professional magicians -> american aviators
television pioneers -> british record labels
meteorological indices -> atmospheric thermodynamics
resins -> non-timber forest products
sonar -> anti-submarine warfare
community organizing -> anarchist theory
states and territories established in the 7th century bc -> g7 nations -> 7th-century bc establishments in asia
shared disk file systems -> distributed file systems supported by the linux kernel
radio stations in north carolina -> espn radio stations
microphones -> applied machine learning
interbank networks -> banking in canada
programming language topics -> computer optimization
secret government programs -> manmohan singh administration -> counter-terrorism in india
economic development -> economic country classifications
american freemasons -> american aviators
20th-century american politicians -> 19th-century american episcopalians
pointing devices -> infrared imaging -> applied machine learning
motor vehicles -> camping
japan -> g7 nations -> 7th-century bc establishments in asia
rowing venues -> rivers of massachusetts -> charles river
surgery -> medical hygiene -> antiseptics
wars involving romania -> wars involving guatemala -> french third republic
industrial gases -> cooling technology
international medical and health organizations -> agriculture in society
musicians from hoboken, new jersey -> grammy lifetime achievement award winners -> 20th-century american male actors
weapons -> united states law -> military technology
rivers of suffolk county, massachusetts -> geobox usage tracking for river type -> charles river
italian renaissance painters -> 16th-century italian sculptors -> 15th-century italian painters
urban studies and planning terminology -> transportation planning
poaceae subfamilies -> bamboo
hydroponic plants -> cucurbitaceae
payment networks -> banking in the united states
equid hybrids -> domesticated animals
requests for audio pronunciation (english) -> huawei
glass physics -> fracture mechanics
military railways -> maritime communication
swing singers -> recipients of the austrian cross of honour for science and art, 1st class -> 20th-century american male actors
culinary terminology -> chefs
speech recognition software -> nuance software
human rights by issue -> abortion law
biology terminology -> biology
publications by format -> non-impact printing
italian male painters -> ac with 19 elements -> 15th-century italian painters
perfect intervals -> octaves -> musical notes
international standards -> free-content attribution
emergency organisations -> continuity of government in the united states
fish of pakistan -> fish of malaysia -> fish of india -> fish of bangladesh
arts -> aesthetics
franklin d. roosevelt -> american anti-fascists -> 19th-century american episcopalians
military life -> alert measurement systems
environmental policies organizations -> environmental agencies in the united states
physical optics -> geometrical optics
japanese robotics -> escalator manufacturers -> aircraft engine manufacturers of japan
national symbols of iraq -> national symbols of armenia -> accipitridae
language versus dialect -> analytic languages
marine edible fish -> fish of pakistan -> fish of bangladesh
national health service (england) -> national agencies for drug regulation -> health education organizations
school qualifications -> logic
jewish skeptics -> disease-related deaths in michigan -> american aviators
polyatomic nonmetals -> antioxidants
video games set in colombia -> video games set in antarctica -> crave entertainment games
christian terminology -> byzantine hymnographers
military facilities in maryland -> military acquisition
membrane biology -> g protein coupled receptors
macos emulation software -> android emulation software
intermolecular forces -> computational chemistry
wars involving montenegro -> wars involving belgium -> french third republic
greek feminine given names -> european feminine given names -> arabic feminine given names
american philanthropists -> 20th-century american male actors
morse code -> brevity codes
out-of-band management -> computer terminals
maritime southeast asia -> java -> greater sunda islands
units of meteorology measurement -> meteorological indices -> atmospheric thermodynamics
travel agencies -> credit card terminology
organisations designated as terrorist by india -> jihadist groups -> anti-shi'ism -> anti-government factions of the syrian civil war
group decision-making -> community organizing -> anarchist theory
defunct radio stations in the united states -> blues radio stations
authentication -> applications of cryptography
hebrew bible people -> christian saints from the old testament -> book of genesis -> adam and eve
joomla extensions -> free customer relationship management software
journalism standards -> associated press
epub readers -> e-books
history of labor relations in the united states -> clinton administration initiatives
macos instant messaging clients -> companies in the prism network
university of perugia alumni -> 15th-century deaths from plague (disease) -> 15th-century christian saints
groups pop -> comics adapted into animated series -> american comics adapted into films
goods manufactured in canada -> blackberry limited mobile phones
psychological horror games -> playstation network games -> playstation 4 games
united states defense procurement -> military facilities in maryland -> military acquisition
wars involving the ottoman empire -> wars involving thailand -> wars involving serbia -> wars involving greece -> wars involving azerbaijan -> french third republic
people from peterborough -> christian female saints of the middle ages -> 7th-century births
flightless birds -> birds of new zealand
stonemasonry -> building stone
woodworking -> craft occupations -> carpentry
media agency -> advertising campaigns
unicode -> symbols
charities based in australia -> air ambulance services in australia
reality -> concepts in epistemology
valve corporation games -> multiplayer online games -> fictional mercenaries
government in the san francisco bay area -> berkeley hills -> antioch, california
samba -> brazilian styles of music
comics adapted into animated series -> american comics adapted into films
space agencies -> european space agency
pitched percussion -> guatemalan musical instruments -> c instruments
sports competitors -> set indices on sports -> most valuable player awards
windows emulation software -> macos emulation software -> android emulation software
healthcare software for windows -> healthcare software for os x -> healthcare software for linux
poisonous fungi -> agaricales genera
dtp for windows -> dtp for os x
pittsburg, california -> congressional districts of california -> concord, california -> antioch, california
computational phylogenetics -> bioinformatics algorithms
scenic design -> entertainment occupations
spokespersons -> political occupations
women of medieval england -> 7th-century english people -> 7th-century births
windows mobile standard software -> pocket pc software
vacuum -> industrial processes -> forming processes
unesco -> science education -> earth sciences
assassination attempt survivors -> american politicians with physical disabilities -> 19th-century american episcopalians
theatrical sound production -> sound production
sustainability and environmental management -> energy efficiency
think tanks based in pakistan -> federalism in pakistan
environmental policy in china -> environmental law in china
national symbols of ghana -> birds of prey -> accipitridae
15th-century italian sculptors -> 15th-century italian painters
organisations designated as terrorist by australia -> anti-government factions of the syrian civil war
malus -> fruits originating in asia -> apples
legal communication -> language varieties and styles -> english language
creationist organisations -> associations of schools
radio by medium -> podcasting
prismatoid polyhedra -> cubes
witchcraft -> magic (paranormal)
merchant services -> electronic funds transfer
best supporting actor golden globe (film) winners -> american film directors -> 20th-century american male actors
online word processors -> online spreadsheets
interactive geometry software -> astronomical databases
academy award for technical achievement winners -> 3d modeling software for linux
genetics -> dna
concepts in ancient greek epistemology -> christology -> christian philosophy
organisations based in australia with royal patronage -> air ambulance services in australia
hip hop duos -> american musical duos -> american hip hop groups
japanese martial arts terminology -> dojos
sculpture materials -> national symbols of finland -> felsic rocks
wars involving taiwan -> wars involving serbia -> french third republic
sports leagues in the united states -> exhibition tennis tournaments
fixed income securities -> fixed income market
the omni group -> macos-only software
escalator manufacturers -> aircraft engine manufacturers of japan
word coinage -> natural language and computing -> globalization terminology
wedding clothing -> suits (clothing) -> 20th-century fashion -> 19th-century fashion
spanish-language radio stations in texas -> cantonese language
biomedical engineering -> biological engineering
radiography -> loughborough university -> casting (manufacturing)
national symbols of the czech republic -> national symbols of nigeria -> national symbols of liechtenstein -> accipitridae
interjections -> american slang
rhizomatous plants -> bamboo
mythography -> homer -> 8th-century bc poets
preâ€“world wide web online services -> bibliographic databases and indexes -> bibliographic database providers
personifications -> latin words and phrases -> greek goddesses
wikis -> hawaiian words and phrases
high german languages -> german-speaking countries and territories -> german language
value added taxes -> tax reform
political scandals in the united states -> copyright infringement of software -> companies that have filed for chapter 7 bankruptcy
multiple barrel firearms -> firearm manufacturers of australia
systems science -> cognitive modeling
energy and instincts -> christian philosophy
robot video games -> oculus rift games -> fictional mercenaries
philosophical logic -> paradoxes
buildings and structures in pasadena, california -> buildings and structures in los angeles county, california -> 20th century in los angeles
heraldic charges -> angels
waste management concepts -> recycling
vietnamese-language radio stations in texas -> spanish-language radio stations in texas -> cantonese language
real object ordering -> animal-powered vehicles
psychopathology -> diagnosis classification
people prosecuted under anti-homosexuality laws -> ballistics experts -> 15th-century italian painters
edible cephalopods -> cenozoic cephalopods
jasminum -> incense material -> flora of samoa
medical statistics -> drug discovery
legal terminology -> equity (law)
airlines of chile -> airlines of brazil
disease-related deaths in michigan -> american aviators
social ethics -> economy and the environment -> codes of conduct -> branding terminology
wars involving haiti -> wars involving greece -> french third republic
dutchess county, new york politicians -> 19th-century american episcopalians
fraud -> crimes
mycenaean greece -> ancient smyrnaeans -> 8th-century bc poets
infantry weapons of the cold war -> 7.62 mm machine guns
life coaching -> coaching
x86 macintosh computers -> imac series
20th-century american singers -> 20th-century american male actors
government agencies of queensland -> emergency services in queensland -> ambulance services in australia
wars involving russia -> wars involving romania -> french third republic
software for modeling software -> disassemblers
hellenistic engineering -> environmental engineering
objective-c -> next
orinda, california -> berkeley hills -> antioch, california
columbia records artists -> 20th-century american male actors
jargon -> english language
neurotransmitters -> ergogenic aids -> adenosine receptor agonists
film -> cinematography
symbian instant messaging clients -> instant messaging server software
festivals of apollo -> ancient greek athletic festivals
victorian-era weapons -> swords -> modern european swords -> early modern european swords -> 18th-century weapons
science-related lists -> life sciences
swords -> 18th-century weapons
central semitic languages -> arabic language
hoffmann-la roche -> amplifiers
stargate sg-1 episodes -> stargate seasons
venture capital firms of the united states -> kohlberg kravis roberts
diaries -> blogs
italian roman catholic saints -> franciscan saints -> 15th-century italian writers -> 15th-century christian saints
hydraulics -> hydraulic engineering -> environmental engineering
materials handling -> lifting equipment -> forklift truck manufacturers
super sentai -> fictional soldiers
15th-century scientists -> 15th-century italian painters
spacecraft manufacturers -> nokia assets
environmental chemistry -> electronic waste in europe
leonardo da vinci -> 15th-century italian painters
peercasting -> copyright law
dollar -> currencies of asia -> circulating currencies
fish of malaysia -> fish of bangladesh
swedish speculative fiction works -> playstation 4 games
oxazolidinediones -> drugboxes which contain changes to watched fields -> anticonvulsants
welfare -> community development
carcinogens -> carcinogenesis
gopher clients -> free web browsers -> firefox
italian friars minor -> diplomats of the holy see -> 15th-century christian saints
male actors from new jersey -> kennedy center honorees -> american crooners -> 20th-century american male actors
powerpc emulators -> android emulation software
woven fabrics -> insect products -> animal glandular products
nasa groups, organizations, and centers -> college of william & mary
japanese language -> agglutinative languages
tose (company) games -> dragon quest
pi-related software -> astronomical databases
wars involving honduras -> french third republic
triumphal arches in russia -> buildings and structures in moscow
education in burlington, vermont -> buildings and structures in burlington, vermont
vietnamese-speaking countries and territories -> member states of the association of southeast asian nations
traditional native american dwellings -> semi-subterranean structures -> navajo culture -> indigenous architecture
software industry -> as a service
literate programming -> haskell programming language family
world war i -> wars involving haiti -> french third republic
midori-kai -> aircraft engine manufacturers of japan
egyptian artefact types -> ancient greek culture -> ancient egyptian symbols
fuyo group -> aircraft engine manufacturers of japan
singers from new jersey -> american crooners -> 20th-century american male actors
world war ii minesweepers of the soviet union -> ships transferred under project hula -> admirable-class minesweepers
2nd-century greek people -> 1st-century romans -> 1st-century greek people
google earth -> geographic coordinate lists
buildings and structures in the manyara region -> airports in tanzania
heroes in mythology and legend -> fictional characters with superhuman strength
quantum optics -> lasers -> directed-energy weapons
rebel groups in syria -> irregular military -> anti-government factions of the syrian civil war
carriages -> animal-powered vehicles
proposed legislation of the 113th united states congress -> internet law in the united states -> copyright enforcement
conservative parties in the united states -> conservative parties
concepts in ethics -> codes of conduct -> branding terminology
game engines that support mantle -> epic games
egalitarianism -> anarchist theory
american people of sicilian descent -> 20th-century american male actors
indoor arenas in canada -> guelph storm -> buildings and structures in guelph
sustainable building in the united states -> building energy rating
video games set in the 22nd century -> psychological horror games -> playstation 4 games
national symbols of liechtenstein -> accipitridae
insurance in the united states -> consumer financial protection bureau -> chris dodd
motor control -> biomechanics
lithtech engine games -> crave entertainment games
united states federal financial legislation -> sarbanesâ€“oxley act
joint chiefs of staff -> chiefs of naval operations
united states department of energy national laboratories -> international space station -> artificial satellites orbiting earth
separatism in iraq -> rebel groups in iraq -> iraq war -> anti-government factions of the syrian civil war
wars involving brazil -> wars involving australia -> french third republic
open hardware electronic devices -> arduino
macintosh all-in-ones -> imac series
globes -> buildings and structures in queens, new york
playstation 3 games -> fictional mercenaries
shareholders -> balance sheet
presidency of lyndon b. johnson -> federal assistance in the united states
standardized tests in the united states -> standardized tests -> educational assessment and evaluation
transport in midi-pyrÃ©nÃ©es -> buildings and structures in aveyron -> airports in france
public health education -> non-departmental public bodies of the united kingdom government -> national health service (england) -> health education organizations
world teamtennis -> sports leagues in the united states -> exhibition tennis tournaments
peer-to-peer software -> macos instant messaging clients -> companies in the prism network
classic mac os word processors -> atari st software
executive directors of the world food programme -> agriculture in society
order theory -> combinatorics
federal reserve system -> banking in the united states
law of obligations -> economy and the environment -> branding terminology
populus -> plant common names -> negligibly senescent organisms
ships built in lorain, ohio -> cold war minesweepers of the soviet union -> admirable-class minesweepers
freedesktop.org libraries -> free multimedia software
statistical data agreements -> non-profit technology
printing materials -> painting materials
trigonal minerals -> luminescent minerals
rebel groups in iraq -> anti-government factions of the syrian civil war
american people of french descent -> american people in the venona papers -> 19th-century american episcopalians
harry houdini -> american aviators
south african music -> music industry associations
livingston family -> assassination attempt survivors -> 19th-century american episcopalians
english alternative rock groups -> british electronic music groups
latin legal terminology -> flagged dictionary definitions
resources -> economic planning
films set in sydney -> films set in lahore
petrology -> mining engineering
united states navy -> united states marine corps
establishments by united states executive order -> classified documents
performance consulting firms -> fidelity national financial -> ceridian
polka derivatives -> lusophone music -> brazilian styles of music
fraud in india -> confidence tricks
international management consulting firms -> fidelity national financial -> ceridian
songs written by beck -> singlechart usages for billboardalternativesongs -> beck songs
neurological disorders in children -> learning disabilities
federally funded research and development centers -> buildings and structures in pasadena, california -> 20th century in los angeles
glass coating and surface modification -> forming processes
quebec awards -> provincial and territorial orders of canada -> members of the national order of quebec
fish of india -> fish of bangladesh
commodities used as an investment -> commodities
italian caricaturists -> 16th-century scientists -> 15th-century italian painters
neoplatonism -> concepts in ancient greek metaphysics
technological universities in the united states -> engineering universities and colleges in massachusetts
cardiac procedures -> cardiac electrophysiology
requests for audio pronunciation (arabic) -> arabic language
islands of indonesia -> greater sunda islands
history of austria-hungary -> french third republic
transatlantic (band) albums -> inside out music albums
lighting -> architectural elements
instant messaging clients -> companies in the prism network
quartz varieties -> dielectrics
italian cuisine -> coffee drinks
emergency communication -> brevity codes
20th-century fashion -> 19th-century fashion
video games developed in sweden -> playstation network games -> playstation 4 games
hellenistic egyptians -> 1st-century greek people
literary theory -> literary criticism
internationalization and localization -> globalization terminology
metal blade records albums -> inside out music albums
formula one entrants -> formula one engine manufacturers -> british auto racing teams
taxonomy -> hierarchy
science and technology in the dutch republic -> microscopy
radar -> air traffic control
dissolution of syria -> anti-government factions of the syrian civil war
power tool manufacturers -> elevator manufacturers -> aircraft engine manufacturers of japan
lasers -> directed-energy weapons
qwest records artists -> converts to roman catholicism from atheism or agnosticism -> 20th-century american male actors
spreadsheet software for windows -> spreadsheet software for macos
recipients of the pour le mÃ©rite (civil class) -> members of the acadÃ©mie des beaux-arts -> 18th-century french painters
selenium -> dietary minerals -> antioxidants
environmentalism -> economics of sustainability
ontario hockey league arenas -> indoor ice hockey venues in canada -> buildings and structures in guelph
engineering vehicles -> construction equipment
garden plants of north america -> garden plants of australia -> bamboo
early modern european swords -> 18th-century weapons
scribes -> clay tablets -> ancient egyptian culture
steel sculptures in new york -> buildings and structures in queens, new york
syndromes -> menstrual cycle
sociology of language -> multilingualism
national symbols of zambia -> national symbols of yemen -> accipitridae
lgbt themes in mythology -> fictional greek people
cretaceous cephalopods -> cenozoic cephalopods
management education -> business qualifications
19th-century french painters -> 18th-century french painters
jean hersholt humanitarian award winners -> grand officers of the order of merit of the italian republic -> american male voice actors -> 20th-century american male actors
types of analytics -> statistical analysis -> financial crime prevention
russian websites -> internet services supporting openid
bibliographic databases and indexes -> bibliographic database providers
g8 nations -> g7 nations -> 7th-century bc establishments in asia
incense material -> flora of samoa
new york state senators -> eleanor roosevelt -> 19th-century american episcopalians
cold war minesweepers of the soviet union -> admirable-class minesweepers
mutualism (movement) -> mutual funds of the united states -> collective investment schemes
cultural property of national significance in basel-stadt -> basel
diplomats of the holy see -> 15th-century christian saints
wireless network organizations -> linux-based devices
nec corporation -> electric vehicle battery manufacturers
christ's hospital -> academic dress
foxconn -> apple inc. hardware
nepal -> historical hindu kingdoms -> former kingdoms -> federal constitutional republics
plutonic rocks -> granite -> felsic rocks
roman goddesses -> latin words and phrases -> greek goddesses
punk rock venues -> nightclubs in new york city -> former music venues in new york city
operas set in italy -> fictional singers -> adaptations of works by victorien sardou
united states federal securities legislation -> united states federal financial legislation -> sarbanesâ€“oxley act
windows instant messaging clients -> skype
christmas-linked holidays -> christian fasting -> advent
public economics -> economic sectors
animal superheroes -> american comics adapted into films
video games set in africa -> crave entertainment games
microsoft hardware -> devices capable of speech recognition -> applied machine learning
webcams -> computing input devices -> applied machine learning
sons of the american revolution -> eleanor roosevelt -> 19th-century american episcopalians
probability -> dimensionless numbers
united nations environment programme -> climate change organizations
optical fiber -> fiber optics
wars involving cuba -> french third republic
prehistoric animal orders -> invertebrate orders
terminology used in multiple sports -> sports trophies and awards -> most valuable player awards
operas based on plays -> operas -> adaptations of works by victorien sardou
steam workshop games -> linux games
italian male sculptors -> fabulists -> 15th-century italian painters
missing people organizations -> forensic databases -> criminal records
psychiatric diagnosis -> learning disabilities
psycholinguistics -> oral communication -> language education
philanthropy -> fundraising -> charity fundraisers
surface-to-air missiles of the united states -> raytheon products -> cold war surface-to-air missiles of the united states
probability distributions -> exponential family distributions -> continuous distributions
latin feminine given names -> greek feminine given names -> arabic feminine given names
united nations general assembly observers -> international olympic committee
persistent programming languages -> pdp-11 -> massachusetts general hospital
web browsers for android -> cross-platform web browsers
userspace file systems -> unix file system-related software
file archivers -> disk image extractors
computer science in the netherlands -> beos text editors
linux text editors -> windows text editors
recreational vehicles -> camping
video game publishers -> electronic arts -> academy of interactive arts & sciences members
self care -> first aid
medical humanities -> health policy
sumitomo group -> electric vehicle battery manufacturers
rockefeller center -> phonograph manufacturers -> organizations awarded an academy honorary award -> national broadcasting company -> former components of the dow jones industrial average
necked box lutes -> czech musical instruments -> bowed instruments
image comics teams -> american comics adapted into films
roman-era alexandrians -> egyptian writers -> 1st-century greek people
male actors of italian descent -> american people of sicilian descent -> 20th-century american male actors
transportation in bucks county, pennsylvania -> buildings and structures in bucks county, pennsylvania -> airports in pennsylvania
16th-century italian sculptors -> 15th-century italian painters
electroencephalography -> brainâ€“computer interfacing
suits (clothing) -> 19th-century fashion
irish musical instruments -> bowed instruments
macos audio editors -> mac os-only software made by apple inc.
italian drinks -> italian cuisine -> coffee drinks
associative arrays -> arrays
united states public health service -> united states department of health and human services agencies -> american medical research
organizations designated as terrorist in asia -> islamic states -> anti-government factions of the syrian civil war
executable file formats -> cp/m files
spanish monarchy -> member states of the union for the mediterranean -> iberian peninsula
buildings and structures in bucks county, pennsylvania -> airports in pennsylvania
kennedy center honorees -> 20th-century american male actors
intergovernmental panel on climate change -> climate change organizations
language education materials -> creative commons-licensed websites
islamic state of iraq and the levant -> irregular military -> anti-government factions of the syrian civil war
clay tablets -> ancient egyptian culture
birds on stamps -> birds by common name -> accipitridae
american performance artists -> american aviators
la hulpe -> financial markets software
online dictionaries -> language education materials -> creative commons-licensed websites
discrete geometry -> computational geometry
police ranks -> detectives and criminal investigators -> administrative law
irregular military -> anti-government factions of the syrian civil war
joining -> iarc group 2b carcinogens
member states of the council of europe -> iberian peninsula
soccer leagues in the united states -> soccer leagues in canada -> major league soccer
song recordings produced by dust brothers -> billboard alternative songs number-one singles -> beck songs
screen actors guild life achievement award -> california republicans -> american pop singers -> 20th-century american male actors
gold rushes -> economic geology
horned deities -> ancient egyptian symbols
livestock -> domesticated animals
veterinary medicine -> branches of biology -> biomedicine
english language tests -> educational assessment and evaluation
florentine painters -> 15th-century italian painters
academic art -> 18th-century french painters
jihadist groups -> anti-government factions of the syrian civil war
united states environmental protection agency -> environmental protection agencies -> environmental agencies in the united states
physical chemistry -> electrochemistry
recommender systems -> entertainment websites
21st century in los angeles -> 20th century in los angeles
buildings and structures in oriental (morocco) -> airfields of the united states army air forces in morocco
silk -> biomaterials -> animal glandular products
data retention -> data laws
printing occupations -> graphic designers
greek historical hero cult -> ancient chians -> 8th-century bc poets
democratic party state governors of the united states -> assassination attempt survivors -> 19th-century american episcopalians
commercial fish -> cold water fish
nickelodeon -> american comics adapted into films
jade -> inosilicates -> hardstone carving -> chinese culture
drugboxes which contain changes to watched fields -> anticonvulsants
presidential medal of freedom recipients -> american people of sicilian descent -> 20th-century american male actors
protected areas -> earth sciences
british racecar constructors -> british auto racing teams
landmarks in queens, new york -> flushing, queens -> buildings and structures in queens, new york
historical hindu kingdoms -> federal constitutional republics
video games set in mexico -> crave entertainment games
integral membrane proteins -> g protein coupled receptors
healthcare software for os x -> healthcare software for linux
monsters -> ancient egyptian symbols
american people of austrian-jewish descent -> american magicians -> american aviators
korea -> divided regions -> disputed territories in asia
numerical analysis software for windows -> numerical analysis software for linux
fantasy creatures -> egyptian legendary creatures -> ancient egyptian symbols
persecution of yazidis -> islamism in syria -> anti-government factions of the syrian civil war
chinese-speaking countries and territories -> china -> brics nations
wars involving rhodesia -> wars involving montenegro -> french third republic
marketing techniques -> advertising techniques
riddles -> egyptian legendary creatures -> ancient egyptian symbols
palo alto, california -> academic enclaves
latin literary phrases -> latin legal terminology -> flagged dictionary definitions
information technology in the netherlands -> beos text editors
national symbols of mexico -> birds on stamps -> accipitridae
operas -> adaptations of works by victorien sardou
bamboo taxa -> bamboo
university of chicago press books -> academic style guides
currencies of africa -> circulating currencies
free simulation software -> electronic design automation software for linux
english musical instruments -> bowed instruments
inquisitors -> inquisition
triple deities -> muses
price fixing convictions -> manufacturers of industrial automation
platinum -> cubic minerals -> catalysts
java -> greater sunda islands
7th-century women -> 7th-century births
non-volatile memory -> computer storage devices
italian-language operas -> fictional singers -> adaptations of works by victorien sardou
schools in sunflower county, mississippi -> private elementary schools in mississippi
the harvard crimson people -> assassination attempt survivors -> 19th-century american episcopalians
internet television -> video on demand services
web browsers for ios -> cross-platform web browsers
top level association football leagues in north america -> professional soccer leagues in the united states -> major league soccer
terrorism in lebanon -> persecution of lgbt people -> islamic state of iraq and the levant -> anti-government factions of the syrian civil war
solid-state computer storage -> computer storage devices
national broadcasting company -> former components of the dow jones industrial average
refractory materials -> non-petroleum based lubricants -> dry lubricants
massachusetts institute of technology -> engineering universities and colleges in massachusetts
werner von siemens -> siemens -> price fixing convictions -> manufacturers of industrial automation
supercomputing in china -> lenovo
laws of china -> environmental law in china
television stations in south carolina -> nbc network affiliates -> american television stations with a three-letter call sign
socialism -> communism -> anarchist theory
dos text editors -> beos text editors
eclipses -> earth phenomena -> astrological aspects
retirement in the united states -> employee retirement income security act
unix package management-related software -> orchestration software
parser generators -> language workbench
video games with commentaries -> fictional mercenaries
unix internet software -> gecko-based software -> firefox
sports venues by type -> buildings and structures by type
touchscreen portable media players -> ipad
mount everest -> federal constitutional republics
wars involving italy -> wars involving british india -> french third republic
file systems supported by the linux kernel -> disk file systems
cities in santa clara county, california -> academic enclaves
leisure activities -> game theory
wages and salaries -> roseland, new jersey -> automatic data processing
grand officers of the order of merit of the italian republic -> 20th-century american male actors
internet of things -> arduino
american male film actors -> american jazz singers -> 20th-century american male actors
member states of the union for the mediterranean -> iberian peninsula
rolling stock manufacturers of japan -> midori-kai -> aircraft engine manufacturers of japan
superhero teams -> nickelodeon -> american comics adapted into films
zonohedra -> cubes
real estate in the united states -> financial regulatory authorities of the united states -> bank regulation in the united states
professional soccer leagues in the united states -> major league soccer
record label distributors -> defunct record labels of the united kingdom -> british record labels
precious metals -> noble metals -> catalysts
cumulus media radio stations -> classic rock radio stations in the united states
nasa facilities -> 20th century in los angeles
operas by giacomo puccini -> adaptations of works by victorien sardou
rehabilitation team -> nursing -> military supporting service occupations
chat websites -> adobe integrated runtime platform software
united states federal criminal legislation -> united states corporate law -> sarbanesâ€“oxley act
microfluidics -> fluid dynamics
wars involving malta -> wars involving brazil -> french third republic
research institutes in california -> 21st century in los angeles -> 20th century in los angeles
tuscan painters -> 16th-century italian painters -> 15th-century italian painters
christology -> christian philosophy
information and communication technologies for development -> globalization terminology
public utilities -> ireland-centric -> flow meters
christian saints from the old testament -> adam and eve
mountaineering -> climbing techniques
free email server software -> email server software for linux
national symbols of syria -> accipitridae
danville, california -> antioch, california
molecular physics -> intermolecular forces -> computational chemistry
international game developers association members -> academy of interactive arts & sciences members
probabilistic models -> latent variable models
glyphs -> adobe typefaces
stochastic simulation -> statistical approximations -> monte carlo methods
isomorphism theorems -> basic concepts in set theory
civil aviation -> carriages and mountings
free dicom software -> free bioimaging software
microcomputers -> history of computing hardware
e7 nations -> chinese-speaking countries and territories -> brics nations
network appliances -> computer printers
pascal programming language family -> delphi (programming language) -> borland
eocene plants -> cacti
video hosting -> entertainment websites
radio stations in wisconsin -> country radio stations in the united states
regular expressions -> formal languages -> automata (computation)
theorem proving software systems -> astronomical databases
consensus -> anarchist theory
cyberpunk themes -> corporate crime
outdoor sculptures in new york city -> flushing, queens -> buildings and structures in queens, new york
healthcare reform legislation in the united states -> controversies in the united states
android (operating system) software -> ios software
wars involving japan -> russo-turkish wars -> french third republic
internet explorer add-ons -> google chrome extensions
buildings and structures in aveyron -> airports in france
given names of greek language origin -> european feminine given names -> arabic feminine given names
unsolved problems in neuroscience -> decision-making
special effects -> computer graphic techniques
histology -> anatomical pathology
software that uses pygtk -> gtk+ language bindings
singlechart usages for uk -> singlechart called without song -> musicbrainz release group different from wikidata -> beck songs
hospitality industry -> etiquette -> cultural anthropology
15th-century deaths from plague (disease) -> 15th-century christian saints
police ranks in the united kingdom -> detectives and criminal investigators -> administrative law
synthetic diamond -> forming processes
delano family -> american people of dutch descent -> american episcopalians -> 19th-century american episcopalians
retailers -> french words and phrases
mnemonic acronyms -> medical mnemonics
macos games -> linux games
platonic solids -> cubes
great britain -> england
national symbols of serbia -> accipitridae
science fiction video games -> playstation 4 games
cubic minerals -> catalysts
file sharing networks -> copyright law
voice technology -> speech processing -> speaker recognition
world food programme -> hunger relief organizations -> agriculture in society
prophets of islam -> adam and eve
violins -> bowed instruments
free video conversion software -> free codecs
software using the academic free license -> ebay
3d graphics software that uses qt -> 3d computer graphics software for linux
trinitarianism -> heraclitus -> christian philosophy
climate change policy -> climate change mitigation
ifpi members -> electronics industry in london -> british record labels
military officers -> command and control
salmonidae -> cold water fish
internal revenue service -> internal revenue code -> controversies in the united states
video games set in the united states -> video games set in russia -> crave entertainment games
topix 100 -> midori-kai -> aircraft engine manufacturers of japan
vehicle telematics -> telematics -> automotive electronics
transition metals -> noble metals -> catalysts
network theory -> complex systems theory -> communication theory
videoconferencing software for linux -> companies in the prism network
statistics -> mathematical and quantitative methods (economics)
american odd fellows -> 19th-century american episcopalians
new jersey republicans -> american crooners -> 20th-century american male actors
21st-century fashion -> 19th-century fashion
submarine warfare -> sonar -> anti-submarine warfare
gases -> astrophysics
types of university or college -> educational television
dos files -> cp/m files
persecution of muslims -> anti-government factions of the syrian civil war
currencies of oceania -> circulating currencies
omers -> fis (company)
symmetric-key algorithms -> key transport protocols
viacom media networks -> groups pop -> american comics adapted into films
linux foundation projects -> joyent
international democrat union member parties -> conservative parties
record charts -> music industry associations
source (game engine) games -> fictional mercenaries
fish common names -> commercial fish -> cold water fish
science and technology in europe -> european space agency
political corruption -> issues in ethics
methods in sociology -> cultural economics
gstreamer -> free multimedia software
software that was ported from gtk+ to qt -> packet analyzer software that uses gtk+ -> macos network-related software
national symbols of romania -> national symbols of armenia -> accipitridae
american male songwriters -> 20th-century american male actors
privacy of telecommunications -> manmohan singh administration -> counter-terrorism in india
r (programming language) -> free r (programming language) software
scoutcraft -> first aid
medical and health organisations based in australia -> charities based in australia -> air ambulance services in australia
radio stations and systems itu -> air traffic control
tree tapping -> papermaking -> non-timber forest products
bounce tv affiliates -> american television stations with a three-letter call sign
requests for audio pronunciation (spanish) -> adobe buildings and structures
shades of green -> chinese culture
former dutch colonies -> aruba -> 10th-century establishments in aruba
russian language -> east slavic languages
relational algebra -> database normalization -> database constraints
earth phenomena -> astrological aspects
wars involving korea -> wars involving guatemala -> french third republic
governors of new york -> 19th-century american episcopalians
semi-subterranean structures -> indigenous architecture
sipem people movers -> siemens -> manufacturers of industrial automation
writing media -> school terminology -> educational devices
insects acting as insect pest control agents -> agriculturally beneficial insects
text messaging -> macos software
helices -> genetics -> dna
web browsers for amigaos -> os/2 web browsers -> firefox
human-headed mythical creatures -> fantasy creatures -> ancient egyptian symbols
child labor in the united states -> 75th united states congress
youtube -> video hosting -> entertainment websites
american film directors -> 20th-century american male actors
islands of the netherlands antilles -> former dutch colonies -> 10th-century establishments in aruba
cold war patrol vessels of the soviet union -> admirable-class minesweepers
music in yorkshire -> british electronic music groups
mumps programming language -> massachusetts general hospital
corporate mascots -> american comics adapted into films
buildings and structures in los angeles county, california -> 20th century in los angeles
university of virginia -> george mason university -> college of william & mary
radio stations in texas -> christian radio stations in the united states -> cantonese language
internet and the european union -> european union -> council of the european union
laser applications -> brazing and soldering
rebel groups in libya -> organisations based in iraq -> anti-government factions of the syrian civil war
formula one constructors -> british auto racing teams
metallurgy -> condensed matter physics
venomous fish -> myliobatiformes -> extant early cretaceous first appearances
gnome libraries -> freedesktop.org libraries -> free multimedia software
organisations based in sindh -> federalism in pakistan
congressional districts of california -> antioch, california
video game hardware -> nvidia software -> computer physics engines
american people of dutch descent -> 19th-century american episcopalians
technical universities and colleges -> engineering universities and colleges in massachusetts
military research facilities of the united states -> military facilities in maryland -> military acquisition
landforms -> fluvial landforms
book of genesis -> adam and eve
syntax -> grammar frameworks -> generative linguistics
indian films -> films set in sydney -> films set in lahore
ambassadors of the republic of florence -> 15th-century italian painters
wars involving greece -> french third republic
stack-oriented programming languages -> postscript -> concatenative programming languages
livejournal -> internet services supporting openid
populated places established in the 10th century -> former dutch colonies -> 10th-century establishments in aruba
animal welfare organizations -> animal charities
comics adapted into television series -> american comics adapted into films
organisations designated as terrorist by the united kingdom -> anti-government factions of the syrian civil war
modern european swords -> 18th-century weapons
iphone video game engines -> epic games
video games developed in canada -> electronic arts games -> crave entertainment games
rivers -> river morphology -> physical geography
united states department of commerce agencies -> national institute of standards and technology -> buildings and structures in gaithersburg, maryland
non-fiction genres -> blogs
reconciliation -> family therapy
public sector -> economic sectors
networks -> file sharing networks -> copyright law
european feminine given names -> arabic feminine given names
gas stations in the united states -> bp
wars involving portugal -> wars involving malta -> french third republic
sport in blackburn -> defunct football clubs in england
works about history -> archives
first-person shooter multiplayer online games -> fictional mercenaries
medical manuals -> clinical procedure classification -> american medical association
interscope records singles -> beck songs
leibniz association -> education in dresden
federal emergency management agency -> emergency services in the united states -> continuity of government in the united states
bell system -> accounting scandals
national symbols of nigeria -> accipitridae
proposed legislation of the 114th united states congress -> copyright enforcement
language and mysticism -> concepts in ancient greek epistemology -> christian philosophy
legal writing -> legal communication -> english language
poaceae -> garden plants of south america -> garden plants of asia -> bamboo
inocybe -> agaricales genera
long bones -> bones of the lower limb
presidents -> etymologies
cryptographic attacks -> anti-forensic software
republican party (united states) -> international democrat union member parties -> conservative parties
prolog programming language family -> logic programming languages
bereshit (parsha) -> adam and eve
television channels in italy -> italian-language television stations
home appliance manufacturers -> electrical wiring and construction supplies manufacturers
political parties in the united states -> international democrat union member parties -> conservative parties
free web browsers -> firefox
eagles -> birds by common name -> accipitridae
birds of prey -> accipitridae
thin film deposition -> plasma processing
serverless database management systems -> embedded databases
ancient greek art -> ancient egyptian symbols
legal literature -> jargon -> english language
religious radio stations in the united states -> radio stations in virginia -> low-power fm radio stations in virginia
ancient chians -> 8th-century bc poets
exercise physiology -> adenosine receptor agonists
statistical hypothesis testing -> logic and statistics
dos technology -> cp/m technology
discontinued google acquisitions -> anti-spam
czech musical instruments -> bowed instruments
sqlite -> serverless database management systems -> embedded databases
organizations awarded an academy honorary award -> former components of the dow jones industrial average
voice over ip clients for linux -> macos instant messaging clients -> companies in the prism network
tort law -> crimes
road transport -> fleet management
free vector graphics editors -> free diagramming software
10th-century monarchs in asia -> 10th-century iranian people
light machine guns -> infantry weapons of the cold war -> 7.62 mm machine guns
singlechart called without song -> beck songs
web browsers that use gtk+ -> web browsers for android -> cross-platform web browsers
megafauna of africa -> herbivorous animals
transhumanism in video games -> swedish speculative fiction works -> playstation 4 games
thin-film cells -> thin films
molecular modelling -> computational chemistry
warez -> hacking (hobbyist) -> disk image emulators -> compact disc and dvd copy protection
windows compression software -> disk image extractors
presidents of the united states -> columbia law school alumni -> 19th-century american episcopalians
new jersey democrats -> las vegas entertainers -> 20th-century american male actors
stable distributions -> multivariate continuous distributions -> continuous distributions
george mason university -> college of william & mary
vaudeville performers -> american freemasons -> american aviators
california democrats -> 20th-century american singers -> 20th-century american male actors
oujda -> airports in morocco -> airfields of the united states army air forces in morocco
new media art -> american art
ziyarid dynasty -> year of birth missing -> 10th-century iranian people
nokia platforms -> accenture
silicon valley -> academic enclaves
high integrity programming language -> avionics programming languages
powerpc linux distributions -> debian -> arm linux distributions
american philatelists -> 19th-century american episcopalians
musicbrainz label not in wikidata -> defunct record labels of the united kingdom -> british record labels
loughborough university -> casting (manufacturing)
egyptian writers -> 1st-century greek people
national agencies for drug regulation -> health education organizations
metaphors -> english-language idioms
spanish-speaking countries and territories -> spain -> iberian peninsula
ireland-centric -> flow meters
star trek fandom -> os/2
semantic wikis -> creative commons-licensed databases
family law in the united states -> clinton administration initiatives
free-to-play video games -> fictional mercenaries
central american and caribbean percussion instruments -> c instruments
nonlinear filters -> change detection
trade associations based in south africa -> record charts -> music industry associations
sports venues in ontario -> guelph storm -> buildings and structures in guelph
systems programming languages -> avionics programming languages
fundraising -> charity fundraisers
concord, california -> antioch, california
units of length -> ammunition
mitsui -> electric vehicle battery manufacturers
omnibus legislation -> healthcare reform legislation in the united states -> controversies in the united states
text editors that use gtk+ -> dos text editors -> beos text editors
heating, ventilating, and air conditioning -> building biology
xslt processors -> xquery processors
one-party states -> communist states
ancient greek culture -> ancient egyptian symbols
inosilicates -> chinese culture
berkeley hills -> antioch, california
nokia -> cac 40
g7 nations -> 7th-century bc establishments in asia
quartz gemstones -> piezoelectric materials -> dielectrics
libertarian theory -> economic sectors
arts administrators -> academic disciplines
database normalization -> database constraints
literacy -> digital divide -> computing and society
deified people -> ancient smyrnaeans -> 8th-century bc poets
people from the province of l'aquila -> franciscan saints -> 15th-century christian saints
risk analysis methodologies -> monte carlo methods
minimum wage law -> 75th united states congress
writings by topic -> medical literature
musical forms -> drama
boolean algebra -> algebraic logic
united states department of justice -> metadata registry
singlechart called without artist -> billboard alternative songs number-one singles -> beck songs
payment cards -> information privacy
priabonian first appearances -> eocene plants -> cacti
comics adapted into video games -> american comics adapted into films
tabulata -> prehistoric animal orders -> invertebrate orders
police weapons -> 18th-century weapons
presentation software for windows -> presentation software for os x
member states of the european union -> member states of nato -> iberian peninsula
italian civil engineers -> 16th-century scientists -> 15th-century italian painters
summer association football leagues -> professional sports leagues in canada -> professional soccer leagues in the united states -> major league soccer
complex systems theory -> communication theory
sustainable building -> buildings and structures by construction material -> adobe buildings and structures
orientalist painters -> academic art -> 18th-century french painters
biology and pharmacology of chemical elements -> antioxidants
hugo award-winning works -> faster-than-light communication
walnut creek, california -> government in the san francisco bay area -> antioch, california
world health organization -> diagnosis classification
detectives and criminal investigators -> administrative law
wars involving thailand -> french third republic
planographic printing -> lithography
stick percussion idiophones -> costa rican musical instruments -> c instruments
singlechart usages for italy -> musicbrainz release group different from wikidata -> beck songs
cities in the san francisco bay area -> academic enclaves
jazz record labels -> electronics industry in london -> british record labels
polish feminine given names -> english given names -> arabic feminine given names
libertarianism -> egalitarianism -> anarchist theory
symbols of wisconsin -> national symbols of finland -> felsic rocks
energy in the united states -> building energy rating
passive fire protection -> computer hardware cooling
analysands of ralph greenson -> american male singers -> 20th-century american male actors
roosevelt family -> groton school alumni -> 19th-century american episcopalians
california republicans -> 20th-century american male actors
banking in india -> bank regulation
american people in the venona papers -> 19th-century american episcopalians
superparticular intervals -> musical notes
airports in georgia (u.s. state) -> airfields of the united states army air forces in georgia (u.s. state)
injection exploits -> cryptographic attacks -> anti-forensic software
radio stations in montana -> classic hits radio stations in the united states
machine guns of the soviet union -> infantry weapons of the cold war -> 7.62 mm machine guns
electronic arts games -> crave entertainment games
exponential family distributions -> continuous distributions
washington & jefferson college -> language education materials -> creative commons-licensed websites
iranian chief technology officers -> american chief technologists
handbooks and manuals -> engineering literature
people from hyde park, new york -> american people of english descent -> 19th-century american episcopalians
mules -> equid hybrids -> domesticated animals
terrorism in iraq -> persecution of lgbt people -> anti-government factions of the syrian civil war
sports governing bodies in ontario -> high school football in canada
environmental protection agencies -> environmental agencies in the united states
operational semantics -> formal specification languages
history of anatomy -> ac with 19 elements -> 15th-century italian painters
waste minimisation -> reuse
groton school alumni -> 19th-century american episcopalians
video game controllers -> applied machine learning
populated coastal places in california -> incorporated cities and towns in california -> academic enclaves
large hadron collider -> cern experiments
wars involving liberia -> wars involving italy -> french third republic
infrared imaging -> applied machine learning
95 births -> 1st-century romans -> 1st-century greek people
sdram -> jedec standards
social philosophy -> grammar
wars involving new zealand -> wars involving haiti -> french third republic
garden plants of asia -> bamboo
withholding taxes -> social security (united states)
trawlers of the soviet navy -> cold war patrol vessels of the soviet union -> admirable-class minesweepers
imperial free cities -> basel
concepts in ancient greek logic -> christian philosophy
verbâ€“subjectâ€“object languages -> requests for audio pronunciation (arabic) -> arabic language
multivariate continuous distributions -> continuous distributions
wars involving sudan -> global conflicts -> french third republic
obsolete occupations -> ancient egyptian culture
source-based linux distributions -> gentoo linux
spam filtering -> discontinued google acquisitions -> anti-spam
greenbelt, maryland -> autodesk acquisitions
video hardware -> television
vehicle technology -> telematics -> automotive electronics
free mobile software -> embedded linux distributions
ancient roman leisure -> ancient greek athletic festivals
ergogenic aids -> adenosine receptor agonists
windows word processors -> atari st software
hacking (hobbyist) -> compact disc and dvd copy protection
sonnet studies -> rhyme
economy and the environment -> branding terminology
human behavior -> experimental psychology
playstation portable -> handheld game consoles
digital preservation -> data publishing
7th-century english people -> 7th-century births
os/2 text editors -> dos text editors -> beos text editors
horse driving -> animal-powered vehicles
xbox 360 hardware -> applied machine learning
national symbols of austria -> accipitridae
20th-century american episcopalians -> 19th-century american episcopalians
franceâ€“switzerland border crossings -> basel
european union -> council of the european union
stem vegetables -> bamboo taxa -> bamboo
trucks -> lifting equipment -> forklift truck manufacturers
15th-century italian writers -> 15th-century christian saints
history of mining -> economic geology
american musical duos -> american hip hop groups
waterfalls -> landforms -> fluvial landforms
la caÃ±ada flintridge, california -> 20th century in los angeles
virginia tech -> college of william & mary
data-flow analysis -> compiler optimizations
satellite internet access -> satellite ground stations
rugby league stadiums in the united states -> engineering universities and colleges in massachusetts
united states department of the treasury agencies -> international sanctions
independent films -> english-language films
ac with 19 elements -> 15th-century italian painters
x-ray scattering -> small-angle scattering
phonograph manufacturers -> former components of the dow jones industrial average
personifications in greek mythology -> personifications -> greek goddesses
buildings and structures in crisp county, georgia -> airports in georgia (u.s. state) -> airfields of the united states army air forces in georgia (u.s. state)
east anglian saints -> 8th-century women -> 8th-century deaths -> 7th-century births
flagship universities in the united states -> buildings and structures in burlington, vermont
unix emulators -> compatibility layers
zen buddhist terminology -> dojos
universities and colleges in tamaulipas -> technical universities and colleges in mexico
monarchy -> monarchs
software using the lppl license -> free tex software
elementary shapes -> cubes
national symbols of poland -> accipitridae
emergency services in queensland -> ambulance services in australia
space-filling polyhedra -> cubes
epic poets -> ancient smyrnaeans -> 8th-century bc poets
professional sports leagues in canada -> major league soccer
latin music genres -> dance music
austro-hungarian emigrants to the united states -> american aviators
jersey -> crown dependencies -> bailiwick of jersey
military electronics of the united states -> equipment of the united states air force
private high schools in mississippi -> private elementary schools in mississippi
glass production -> fiber optics
american male singers -> 20th-century american male actors
free software testing tools -> free memory debuggers
environments -> astronomical dynamical systems
organisations based in rome -> executive directors of the world food programme -> agriculture in society
taxa named by elias magnus fries -> inocybe -> agaricales genera
cryptography organizations -> buildings and structures in gaithersburg, maryland
nhs wales -> national agencies for drug regulation -> health education organizations
lobbying organizations -> industry trade groups based in the united states
school terminology -> educational devices
law enforcement databases in the united states -> forensic databases -> criminal records
19th-century painters of historical subjects -> 18th-century french painters
franciscan saints -> 15th-century christian saints
organizations designated as terrorist by turkey -> anti-government factions of the syrian civil war
watersheds of boston harbor -> rivers of massachusetts -> charles river
science and technology during world war ii -> radar -> air traffic control
8th-century women -> 7th-century births
wars involving the united kingdom -> french third republic
openpgp -> history of cryptography
digital divide -> computing and society
spain -> iberian peninsula
homer -> 8th-century bc poets
united states department of commerce -> military technology
delphi (programming language) -> borland
french neoclassical painters -> alumni of the Ã©cole des beaux-arts -> 18th-century french painters
admirable-class minesweepers of the soviet navy -> admirable-class minesweepers
chalcogens -> antioxidants
rivers of norfolk county, massachusetts -> geobox usage tracking for river type -> charles river
vehicle insurance -> automobile costs
new york democrats -> democratic party presidents of the united states -> 19th-century american episcopalians
vi -> information technology in the netherlands -> beos text editors
squid -> cretaceous cephalopods -> cenozoic cephalopods
non-departmental public bodies of the united kingdom government -> health education organizations
song forms -> hymns -> byzantine hymnographers
gas technologies -> fluid dynamics
formal languages -> automata (computation)
statistical analysis -> financial crime prevention
zoomable user interfaces -> panorama viewers
mountain biking -> endurance sports
nuclear command and control -> maritime communication
file hosting for macos -> email attachment replacements
telecommunications in india -> privacy of telecommunications -> counter-terrorism in india
government of contra costa county, california -> danville, california -> antioch, california
fictional ninja -> animal superheroes -> american comics adapted into films
urban planning -> community development
defunct record labels of the united kingdom -> british record labels
organisations designated as terrorist by pakistan -> jihadist groups -> anti-government factions of the syrian civil war
musicians from budapest -> american skeptics -> american aviators
blade weapons -> 18th-century weapons
great recession in the united states -> consumer financial protection bureau -> chris dodd
toxicology -> chemical safety
trade secrets -> corporate crime
commercial molluscs -> cenozoic cephalopods
greek speculative fiction writers -> 8th-century bc poets
superhard materials -> corundum gemstones -> aluminium minerals
billboard alternative songs number-one singles -> beck songs
wars involving australia -> french third republic
navy chiefs of staff -> chiefs of naval operations
firelighting using percussion -> firelighting
wars involving sri lanka -> wars involving rhodesia -> french third republic
religious belief and doctrine -> dogmatism
purines -> chemboxes which contain changes to watched fields -> adenosine receptor agonists
speech impediments -> specific developmental disorders
octaves -> musical notes
national symbols of germany -> accipitridae
scientific nomenclature -> hierarchy
frank sinatra -> 20th-century american male actors
tennis organisations -> sports leagues in the united states -> exhibition tennis tournaments
satellites -> meteorological data and networks
wars involving nepal -> wars involving greece -> french third republic
free proxy servers -> forward proxy
wars involving the states and peoples of oceania -> wars involving korea -> french third republic
phylogenetics -> computational phylogenetics -> bioinformatics algorithms
taxation-related lists -> international taxation
fictional mutants -> comics adapted into animated series -> american comics adapted into films
salafi groups -> persecution of muslims -> anti-government factions of the syrian civil war
aruba -> 10th-century establishments in aruba
sailing rigs and rigging -> clippers
nvidia software -> computer physics engines
world meteorological organization -> intergovernmental panel on climate change -> climate change organizations
medical treatments -> medical mnemonics
anti-shi'ism -> anti-government factions of the syrian civil war
stanzaic form -> rhyme
16th-century italian painters -> 15th-century italian painters
republics -> china -> brics nations
n11 codes -> federal communications commission -> emergency telephone numbers
siemens -> manufacturers of industrial automation
world war ii political leaders -> american philatelists -> 19th-century american episcopalians
energy policy -> energy models -> climate change mitigation
fictional singers -> adaptations of works by victorien sardou
waste legislation in the united kingdom -> environmental chemistry -> electronic waste in europe
environmental social science concepts -> economics of sustainability
mineral exploration -> economic geology
mercury (element) -> electronic waste in europe
wars involving nicaragua -> wars involving canada -> french third republic
politics of iraq -> persecution of christians -> anti-government factions of the syrian civil war
politics of syria -> organisations designated as terrorist by india -> anti-government factions of the syrian civil war
tor hidden services -> free instant messaging clients
packaging (microfabrication) -> chip carriers
personal area networks -> home automation
plant subfamilies -> national symbols of saint lucia -> bamboo
north american numbering plan -> n11 codes -> emergency telephone numbers
drought-tolerant plants -> cacti
general chemistry -> chemical substances
german feminine given names -> european feminine given names -> arabic feminine given names
wars involving serbia -> french third republic
scientific terminology -> interlingua
philosophy of life -> philosophical theories -> new thought beliefs
punjabi-language films -> pakistani films -> films set in lahore
multiplayer and single-player video games -> first-person shooters
food and drink -> chefs
western classical music styles -> musical improvisation
raycom media -> grit affiliates -> american television stations with a three-letter call sign
ethical codes -> branding terminology
people associated with the new deal -> 19th-century american episcopalians
microkernels -> blackberry limited
iso member bodies -> charities based in washington, d.c.
shipping -> merchant navy
traditional pop music singers -> american male voice actors -> 20th-century american male actors
narratology -> fiction -> fantasy tropes
papermaking -> non-timber forest products
welfare and service organizations -> welfare -> community development
myliobatiformes -> extant early cretaceous first appearances
world wide web consortium -> technology consortia
physics institutes -> education in dresden
free erp software -> free accounting software
world's fair architecture in the united states -> globes -> buildings and structures in queens, new york
persecution of lgbt people -> anti-government factions of the syrian civil war
democratic party (united states) vice presidential nominees -> 20th-century american episcopalians -> 19th-century american episcopalians
regional aviation association of australia -> organisations based in australia with royal patronage -> air ambulance services in australia
tam airlines -> latam airlines group -> airlines of brazil
sun microprocessors -> sparc microprocessor architecture
pupils of jacques-louis david -> french male painters -> 18th-century french painters
united states department of defense agencies -> establishments by united states executive order -> classified documents
texas instruments hardware -> embedded microprocessors -> digital signal processors
rca -> organizations awarded an academy honorary award -> former components of the dow jones industrial average
electronic arts -> academy of interactive arts & sciences members
ethical investment -> codes of conduct -> branding terminology
american people of english descent -> 19th-century american episcopalians
volume -> space-filling polyhedra -> cubes
science and technology in the greater los angeles area -> buildings and structures in pasadena, california -> 20th century in los angeles
rafael advanced defense systems -> elta products
web syndication -> radio by medium -> podcasting
products by company -> computing-related lists
garden plants of australia -> bamboo
prisms -> optical components
moveable holidays (to check) -> advent
garden plants of south america -> bamboo
radio stations in connecticut -> classic rock radio stations in the united states
unrecognized or largely unrecognized states -> politics of syria -> anti-government factions of the syrian civil war
graphite -> dry lubricants
powerpc macintosh computers -> imac series
voip services -> companies in the prism network
sources needing translation -> multiple barrel firearms -> firearm manufacturers of australia
buildings and structures by construction material -> adobe buildings and structures
software version histories -> ios development software
video games set in sri lanka -> video games set in russia -> crave entertainment games
comics adapted into plays -> american comics adapted into films
supernatural legends -> ghosts
elevator manufacturers -> aircraft engine manufacturers of japan
environmental protection -> environmental chemistry -> electronic waste in europe
reagan administration controversies -> companies that have filed for chapter 7 bankruptcy
google chrome apps -> android wear software
emergency services in the united states -> continuity of government in the united states
airports in morocco -> airfields of the united states army air forces in morocco
privacy software -> internet privacy software -> history of cryptography
microbiology equipment -> 17th-century introductions
best musical or comedy actor golden globe (film) winners -> 20th-century american male actors
programming language semantics -> formal specification languages
roman epirus -> ancient roman leisure -> ancient greek athletic festivals
science software for os x -> science software for linux
granite -> felsic rocks
national security agency encryption devices -> general dynamics mission systems
wars involving france -> french third republic
open-source movement -> criticism of intellectual property
tides -> geodesy
wars involving costa rica -> french third republic
set indices on sports -> most valuable player awards
world war ii minesweepers of the united states -> world war ii minesweepers of the soviet union -> admirable-class minesweepers
rendering systems -> 3d rendering software for linux
debian -> arm linux distributions
former monarchies of asia -> federal constitutional republics
cities in switzerland -> basel
numerical analysis software for os x -> numerical analysis software for linux
hungarian jews -> american aviators
organisations based in assam -> human rights organisations based in india
